11111111111111
11E10001C0000111
1101C00100000111
10011000110001111
1001001C00000111
1000000P00000111
11111111111111