1111111111
1C10C00001
10C1000001
1100000E01
100101CP01
1111111111