11111111111111
11E10001C00001
1101C001000001
10011000110001
1001001C000001
1000000P000001
10011111111111