111111
1001C1
101111
100001
100001
111111