11111111111111
11E10001C00001
1101C001000001
10000000000001
10111000110001
10000011111111
1001001C000001
100000P0000001
11111111111111
